1111111111
1P01000001
1001011101
101101G101
1010010101
1010B00101
1011110101
1000000101
1000000001
1111111111
