1111111111
1P00000001
1000010001
1000010001
1000000001
1000B000G1
1000010001
1000010001
1000000001
1111111111
