1111111111
1P00000001
1111011101
1000000001
1011111101
1000000G01
1011111101
1000000001
1000000B01
1111111111
