1111111111
1P00000001
1111011101
1000000001
1000B000G1
1011111101
1000B000G1
1111011101
1000000001
1111111111
