1111111111
1P00000001
1000010001
1B00000001
1011111101
1G000000G1
1011111101
1B000000B1
1000010001
1111111111
