1111111111
1P00000001
1B000000B1
1G000000G1
1000010001
1000010001
1000010001
1000000001
1000000001
1111111111
