1111111111
1P00000001
1000010001
1B11111001
1G00000001
1B111110G1
1B00000001
1011111101
1000000001
1111111111
