1111111111
1P00000001
1011111101
1B00000001
1011111101
1B000000G1
1011111101
1B000000G1
100000000G
1111111111
